***********************************
*************e    !**  b $*********
*     ***************     **a   ***
*        ************    a***** ***
** e     ****     ************   **
*        ****     c**********     *
*       ******     ***b     ** @ **
*  $*   ******     ***      *******
*****     d***d    ***c    $*******
***********************************
