**********
* ------ *
*       |*
*-      |*
*      -|*
*        *
*       @*
**********
