*********************
*****$             <*
***** ***********   *
***** **>          >*
*****       *********
*****       *********
*    >*     *********
* ******$      <*****
* ************* *****
* **********    *****
*  <******     >*****
**  ******    *******
*> >*****   *********
*  ***$ !    ********
*<     ** @ *********
*********************
