***********************
***$   *   ~~~  *******
***    *** ***   ******
***    ~~~ **     *****
****** ~~~ *** @ **   *
******~************   *
******~   !  a***     *
*****     *******  $***
*****     *******   ***
*****     ***a   >  ***
******* ********* *****
*******$         >*****
***********************
