**********
*        *
*        *
*  ↑    @*
**********
